* *  * **** 
**  **  ** *
 ********   
**   * *   *
*  **     **
****  ****  
 *  * * *  *
 *    ****  
 *   ** * **
  ** ***  * 
 * * * *    
 ***  ***   
